{
	"map": [
		{
			"name": "newbark",
			"imgSrc": "src/newbark_route29.bmp",
			"width": 80,
			"height": 25,
			"infoArray": [
			//	 0, 1, 2, 3, 4, 5, 6, 7, 8, 9,10,11,12,13,14,15,16,17,18,19,20,21,22,23,24,25, 1, 1, 1, 1, 1, 1, 1, 1, 1, 1, 1, 1, 1, 1, 1, 1, 1, 1, 1, 1, 1, 1, 1, 1, 1, 1, 1, 1, 1, 1, 1, 1, 1, 1,60,61,62,63,64,65,66,67,68,69,70,71,72,73,74,75,76,77,78,79
				[1, 1, 1, 1, 1, 1, 1, 1, 1, 1, 1, 1, 1, 1, 1, 1, 1, 1, 1, 1, 1, 1, 1, 1, 1, 1, 1, 1, 1, 1, 1, 1, 1, 1, 1, 1, 1, 1, 1, 1, 1, 1, 1, 1, 1, 1, 1, 1, 1, 1, 1, 1, 1, 1, 1, 1, 1, 1, 1, 1, 1, 1, 1, 1, 1, 1, 1, 1, 1, 1, 1, 1, 1, 1, 1, 1, 1, 1, 1, 1],
				[1, 1, 1, 1, 1, 1, 1, 1, 1, 1, 1, 1, 1, 1, 1, 1, 1, 1, 1, 1, 1, 1, 1, 1, 1, 1, 1, 1, 1, 1, 1, 1, 1, 1, 1, 1, 1, 1, 1, 1, 1, 1, 1, 1, 1, 1, 1, 1, 1, 1, 1, 1, 1, 1, 1, 1, 1, 1, 1, 1, 1, 1, 1, 1, 1, 1, 1, 1, 1, 1, 1, 1, 1, 1, 1, 1, 1, 1, 1, 1],
				[1, 1, 1, 1, 1, 1, 1, 1, 1, 1, 1, 1, 1, 1, 1, 1, 1, 1, 1, 1, 1, 1, 1, 1, 1, 1, 1, 1, 1, 1, 1, 1, 1, 1, 1, 1, 1, 1, 1, 1, 1, 1, 1, 1, 1, 1, 1, 1, 1, 1, 1, 1, 1, 1, 1, 1, 1, 1, 1, 1, 1, 1, 1, 1, 1, 1, 1, 1, 1, 1, 1, 1, 1, 1, 1, 1, 1, 1, 1, 1],
				[1, 1, 1, 1, 1, 1, 1, 1, 1, 1, 1, 1, 1, 1, 1, 1, 1, 1, 1, 1, 1, 1, 1, 1, 1, 1, 1, 1, 1, 1, 1, 1, 1, 1, 1, 1, 1, 1, 1, 1, 1, 1, 1, 1, 1, 1, 1, 1, 1, 1, 1, 1, 1, 1, 1, 1, 1, 1, 1, 1, 1, 1, 1, 1, 1, 1, 1, 1, 1, 1, 1, 1, 1, 1, 1, 1, 1, 1, 1, 1],
				[1, 1, 1, 1, 1, 1, 1, 1, 1, 1, 1, 0, 0, 0, 1, 1, 1, 1, 1, 1, 1, 1, 1, 1, 1, 1, 1, 1, 1, 1, 1, 1, 1, 1, 1, 1, 1, 1, 1, 1, 1, 1, 1, 1, 1, 1, 1, 1, 1, 1, 1, 1, 1, 1, 1, 1, 1, 1, 1, 1, 1, 1, 1, 1, 1, 1, 1, 1, 1, 1, 1, 1, 1, 1, 1, 1, 1, 1, 1, 1],
				[1, 1, 1, 1, 1, 1, 1, 1, 1, 1, 1, 0, 0, 0, 0,16, 0, 0, 0, 1, 1, 1, 1, 1, 0, 0, 0, 0, 0, 0, 1, 1, 1, 1, 1, 1, 1, 1, 2, 2, 2, 2, 2, 2, 2, 2, 0, 0, 0, 1, 1, 1, 1, 1, 1, 1, 1, 1, 1, 1, 1, 1, 0, 0, 1, 1, 1, 1, 1, 1, 1, 1, 1, 1, 1, 1, 1, 1, 1, 1],
				[1, 1, 1, 1, 1, 1, 1, 1, 1, 1, 0, 0, 0, 0, 0,16, 0, 0, 0, 0, 0, 0, 1, 1, 0, 0, 0, 0, 0, 0, 1, 1, 1, 1, 1, 1, 1, 1, 2, 2, 2, 2, 2, 2, 2, 2, 1, 1, 1, 1, 1, 1, 1, 1, 1, 1, 1, 1, 1, 1, 1, 1, 0, 4, 1, 1,30, 1, 1, 1, 1, 1, 1, 1, 1, 1, 1, 1, 1, 1],
				[1, 1, 0, 0, 0, 0, 1, 1, 1, 1, 0, 0, 0, 0, 0,16, 2, 2, 2, 2, 0, 0, 0, 1, 0, 0, 0, 0, 0, 0, 1, 1, 1, 1, 2, 2, 0, 0, 2, 2, 2, 2, 2, 2, 1, 1, 1, 1, 1, 1, 1, 1, 1, 1, 1, 1, 1, 1, 1, 1, 1, 1, 0, 0, 0, 0, 0, 0, 0, 0, 0, 0, 1, 1, 1, 1, 1, 1, 1, 1],
				[1, 1, 0, 4, 0, 0, 0, 1, 1, 1,18, 0,18,18,18, 1, 2, 2, 2, 2, 1, 0, 0, 0, 0, 0, 0, 0, 0, 0, 0, 1, 1, 1, 2, 2, 0, 0, 2, 2, 2, 2, 2, 2, 1, 1, 1, 1, 1, 1, 1, 1, 1, 1, 1, 1, 1, 1, 1, 1, 1, 1, 0, 0, 0, 0, 0, 0, 0, 0, 0, 4, 1,30, 1, 1, 1, 1, 1, 1],
				[0, 0, 0, 0, 0, 0, 0, 0,15, 0, 2, 2, 2, 2, 2, 2, 2, 2, 1, 1, 1, 0, 0, 0, 0, 0, 0, 0, 0, 0, 0, 0, 2, 2, 2, 2, 2, 2, 1, 1, 0, 0, 1, 1, 1, 1, 1, 1, 1, 0, 0, 0, 0, 0, 1, 1, 1, 1, 1, 1, 1, 1, 0, 0, 0, 0, 0, 0, 0, 0, 0, 0, 0, 0, 0, 0, 0, 0, 3, 3],
				[0, 0, 0, 0, 0, 0, 0, 0,15, 0, 2, 2, 2, 2, 2, 2, 2, 2, 1, 1, 1, 1, 1, 0, 0, 0, 0, 0, 0, 0, 0, 0, 2, 2, 2, 2, 2, 2, 1, 1, 0, 0, 1, 1, 1, 1, 1, 0, 0, 0, 0, 4, 0, 0, 1, 1, 1, 1, 1, 1, 1, 1, 0, 0, 0, 0, 0, 0, 0, 0, 0, 0, 0, 0, 0, 0, 0, 0, 3, 3],
				[1, 1, 1, 1, 0, 0, 0, 0,15, 0, 0, 0, 0, 0, 0, 1, 1, 1, 1, 1, 1, 1, 1, 0, 0, 0, 0, 0, 0, 0, 0, 0, 1, 1, 1, 1, 2, 2, 1, 1, 2, 2, 0,16, 0, 0, 0, 0, 0, 0, 0, 0, 0, 0, 0, 0, 0, 0, 0, 0, 0, 0, 0, 0, 0, 0, 0, 0, 4, 0, 0, 0, 0, 0, 0, 0, 0, 0, 3, 3],
				[1, 1, 1, 1, 0, 0, 0, 0, 1,18,18, 0,18,18, 1, 1, 1, 1, 1, 1, 1, 1, 1, 1,18,18,18,18, 1, 1, 5, 1, 1, 1, 1, 1, 2, 2, 1, 1, 2, 2, 0,16, 0, 0, 0, 0, 0, 0, 0, 0, 0, 0, 0, 0, 0, 0, 0, 0, 0, 0, 0, 0, 0, 0, 0, 0, 0, 0, 0, 0, 0, 0, 0, 0, 0, 0, 3, 3],
				[1, 1, 1, 1, 2, 2, 0, 0, 0, 0, 0, 0, 0, 0, 0, 0, 0, 0, 0, 0, 0, 1, 1, 1, 0, 0, 0, 0,15, 0, 0, 0, 0, 0, 0, 0, 0, 0, 0, 0, 2, 2, 0,16, 2, 2, 2, 2, 0, 0, 0, 0, 0, 0, 1, 1, 1, 1, 1, 1, 1, 1, 1, 1, 1, 1, 0, 0, 0, 0, 0, 0, 0, 0, 0, 0, 0, 1, 1, 1],
				[1, 1, 1, 1, 2, 2, 0, 0, 0, 0, 0, 0, 0, 0, 0, 0, 0, 1, 1, 1, 0, 5, 0, 0, 0, 0, 0, 0,15, 0, 0, 0, 0, 0, 0, 0, 0, 0, 0, 0, 2, 2, 0,16, 2, 2, 2, 2, 0, 0, 0, 0, 0, 0, 1, 1, 1, 1, 1, 1, 1, 1, 1,30, 1, 1, 0, 0, 0, 0, 0, 0, 0, 0, 0, 0, 0, 1, 1, 1],
				[1, 1, 1, 1, 2, 2, 2, 2, 2, 2, 1, 1, 1, 0, 0, 0, 0, 0, 1, 1, 1, 1, 1, 0, 0, 0, 0, 0,15, 0, 0, 0, 0, 0, 0, 1, 1, 1, 0, 0, 0, 0, 0,16, 2, 2, 2, 2, 2, 2, 2, 2, 2, 2, 1, 1, 1, 1, 1, 1, 0, 0, 0, 0, 0, 0, 0, 0, 0, 0, 1, 1, 1, 1, 0, 0, 0, 1, 1, 1],
				[1, 1, 1, 1, 2, 2, 2, 2, 2, 2, 1, 1, 1, 1,18,18,18,18, 1, 1, 1, 1, 0, 0, 0, 0, 0, 0, 1,18,18, 1,18,18, 1, 1, 1, 1,18,18,18,18,18, 1, 2, 2, 2, 2, 2, 2, 2, 2, 2, 2, 1, 1, 1, 1, 1, 1, 0, 0, 0, 0, 0, 0, 0, 0, 0, 4, 1,30, 1, 1, 0, 0, 0, 1, 1, 1],
				[1, 1, 1, 1, 2, 2, 2, 2, 1, 1, 1, 1, 1, 1, 0, 0, 0, 0, 0, 0, 0, 0, 0, 0, 0, 0, 0, 0, 0, 0, 0, 0, 0, 0, 1, 1, 1, 1, 2, 2, 2, 2, 2, 2, 2, 2, 2, 2, 1, 1, 1, 1, 1, 1, 1, 1, 1, 1, 1, 1, 1, 1, 0, 0, 0, 0, 0, 0, 0, 0, 0, 0, 0, 0, 0, 0, 0, 1, 1, 1],
				[1, 1, 1, 1, 2, 2, 2, 2, 1, 1, 1, 1, 1, 1, 0, 0, 0, 0, 0, 0, 0, 0, 0, 0, 0, 0, 0, 0, 0, 0, 0, 0, 0, 0, 1, 1, 1, 1, 2, 2, 2, 2, 2, 2, 2, 2, 2, 2, 1, 1, 1, 1, 1, 1, 1, 1, 1, 1, 1, 1, 1, 1, 1, 1, 1, 1, 0, 0, 0, 0, 0, 0, 0, 0, 0, 0, 0, 1, 1, 1],
				[1, 1, 1, 1, 1, 1, 1, 1, 1, 1, 1, 1, 1, 1, 1, 1, 1, 1, 1, 1, 1, 1, 1, 1, 0, 0, 0, 0, 0, 0, 0, 0, 0, 0, 0, 0, 0, 0, 0, 0, 2, 2, 2, 2, 1, 1, 1, 1, 1, 1, 1, 1, 1, 1, 1, 1, 1, 1, 1, 1, 1, 1, 1, 1, 1, 1, 1, 1, 1, 1, 1, 1, 1, 1, 1, 1, 1, 1, 1, 1],
				[1, 1, 1, 1, 1, 1, 1, 1, 1, 1, 1, 1, 1, 1, 1, 1, 1, 1, 1, 1, 1, 1, 1, 1, 1, 1, 0, 0, 0, 0, 0, 0, 0, 0, 0, 0, 0, 0, 0, 0, 2, 2, 2, 2, 1, 1, 1, 1, 1, 1, 1, 1, 1, 1, 1, 1, 1, 1, 1, 1, 1, 1, 1, 1, 1, 1, 1, 1, 1, 1, 1, 1, 1, 1, 1, 1, 1, 1, 1, 1],
				[1, 1, 1, 1, 1, 1, 1, 1, 1, 1, 1, 1, 1, 1, 1, 1, 1, 1, 1, 1, 1, 1, 1, 1, 1, 1, 1, 1, 1, 1, 1, 1, 1, 1, 1, 1, 1, 1, 1, 1, 1, 1, 1, 1, 1, 1, 1, 1, 1, 1, 1, 1, 1, 1, 1, 1, 1, 1, 1, 1, 1, 1, 1, 1, 1, 1, 1, 1, 1, 1, 1, 1, 1, 1, 1, 1, 1, 1, 1, 1],
				[1, 1, 1, 1, 1, 1, 1, 1, 1, 1, 1, 1, 1, 1, 1, 1, 1, 1, 1, 1, 1, 1, 1, 1, 1, 1, 1, 1, 1, 1, 1, 1, 1, 1, 1, 1, 1, 1, 1, 1, 1, 1, 1, 1, 1, 1, 1, 1, 1, 1, 1, 1, 1, 1, 1, 1, 1, 1, 1, 1, 1, 1, 1, 1, 1, 1, 1, 1, 1, 1, 1, 1, 1, 1, 1, 1, 1, 1, 1, 1],
				[1, 1, 1, 1, 1, 1, 1, 1, 1, 1, 1, 1, 1, 1, 1, 1, 1, 1, 1, 1, 1, 1, 1, 1, 1, 1, 1, 1, 1, 1, 1, 1, 1, 1, 1, 1, 1, 1, 1, 1, 1, 1, 1, 1, 1, 1, 1, 1, 1, 1, 1, 1, 1, 1, 1, 1, 1, 1, 1, 1, 1, 1, 1, 1, 1, 1, 1, 1, 1, 1, 1, 1, 1, 1, 1, 1, 1, 1, 1, 1],
				[1, 1, 1, 1, 1, 1, 1, 1, 1, 1, 1, 1, 1, 1, 1, 1, 1, 1, 1, 1, 1, 1, 1, 1, 1, 1, 1, 1, 1, 1, 1, 1, 1, 1, 1, 1, 1, 1, 1, 1, 1, 1, 1, 1, 1, 1, 1, 1, 1, 1, 1, 1, 1, 1, 1, 1, 1, 1, 1, 1, 1, 1, 1, 1, 1, 1, 1, 1, 1, 1, 1, 1, 1, 1, 1, 1, 1, 1, 1, 1]
				
			],
			"linkedMap": ["lab", "playerhouse01", "newbark_house00", "newbark_house01"],
			"linkedIndex" : [ { "x": 66, "y": 6 }, { "x": 73, "y": 8 }, { "x": 63, "y": 14 }, { "x": 71, "y": 16 } ],
			"npc": ["newbark_woman", "newbark_fat"]
		},
		{
			"name": "playerhouse00",
			"imgSrc": "src/house/player_room1.bmp",
			"width": 8,
			"height": 6,
			"infoArray": [
				[1, 1, 1, 1, 1, 1, 1,30],
				[0, 0, 1, 1, 1, 1, 0, 0],
				[0, 0, 0, 0, 0, 0, 0, 0],
				[0, 0, 0, 0, 0, 0, 0, 0],
				[1, 0, 0, 0, 1, 1, 0, 0],
				[1, 0, 0, 0, 0, 0, 0, 0]
			],
			"linkedMap": ["playerhouse01"],
			"linkedIndex" : [ { "x": 7, "y": 0 } ],
			"npc": []
		},
		{
			"name": "playerhouse01",
			"imgSrc": "src/house/player_room2.bmp",
			"width": 10,
			"height": 8,
			"infoArray": [
				[1, 1, 1, 1, 1, 1, 1, 1, 1,30],
				[1, 1, 1, 1, 1, 1, 0, 0, 0, 0],
				[0, 0, 0, 1, 0, 0, 0, 0, 0, 0],
				[0, 0, 0, 1, 0, 1, 1, 0, 0, 0],
				[0, 0, 0, 0, 0, 1, 1, 0, 0, 0],
				[0, 0, 0, 0, 0, 0, 0, 0, 0, 0],
				[0, 0, 0, 0, 0, 0, 0, 0, 0, 0],
				[0, 0, 0, 0, 0, 0,31,31, 0, 0]
			],
			"linkedMap": ["playerhouse00", "newbark", "newbark"],
			"linkedIndex" : [ { "x": 9, "y" : 0 }, { "x": 6, "y" : 7 }, { "x": 7, "y" : 7 } ],
			"npc": ["mom"]
		},
		{
			"name": "newbark_house00",
			"imgSrc": "src/house/house00.bmp",
			"width": 8,
			"height": 8,
			"infoArray": [
				[1, 1, 1, 1, 1, 1, 1, 1],
				[1, 1, 1, 0, 0, 0, 0, 1],
				[0, 0, 0, 0, 0, 0, 0, 0],
				[0, 0, 0, 1, 1, 0, 0, 0],
				[0, 0, 0, 1, 1, 0, 0, 0],
				[0, 0, 0, 0, 0, 0, 0, 0],
				[1, 0, 0, 0, 0, 0, 0, 1],
				[1, 0,31,31, 0, 0, 0, 1]
			],
			"linkedMap": [ "newbark", "newbark"],
			"linkedIndex" : [ { "x": 2, "y" : 7 }, { "x": 3, "y" : 7 } ],
			"npc": ["newbark_house00_woman"]
		},
		{
			"name": "newbark_house01",
			"imgSrc": "src/house/house01.bmp",
			"width": 7,
			"height": 8,
			"infoArray": [
				[1, 1, 1, 1, 1, 1, 1],
				[1, 0, 0, 0, 1, 1, 1],
				[0, 0, 0, 0, 0, 0, 0],
				[0, 0, 0, 1, 1, 0, 0],
				[0, 0, 0, 1, 1, 0, 0],
				[0, 0, 0, 0, 0, 0, 0],
				[0, 0, 0, 0, 0, 0, 0],
				[0, 0,31,31, 0, 0, 0]
			],
			"linkedMap": [ "newbark", "newbark"],
			"linkedIndex" : [ { "x": 2, "y" : 7 }, { "x": 3, "y" : 7 } ],
			"npc": ["newbark_house01_woman", "newbark_house01_boy"]
		}
	],
}
